ABK = "countries/abkhazia.txt"
AAL = "countries/alandislands.txt"
AND = "countries/Andorra.txt"
ANT = "countries/Antiguaandbarbuda.txt"
ART = "countries/artsakh.txt"
FSA = "countries/Azerbaijan.txt"
BHR = "countries/bahrain.txt"
BRB = "countries/barbados.txt"
BAV = "countries/bavaria.txt"
BRT = "countries/britanny.txt"
CTL = "countries/catalonia.txt"
COM = "countries/comoros.txt"
CKI = "countries/cookislands.txt"
COR = "countries/corsica.txt"
DMI = "countries/dominica.txt"
CHC = "countries/exchechen.txt"
TRK = "countries/exeastturkmenistan.txt"
BDR = "countries/exradabelarusiandemrep.txt"
LAS = "countries/exroyallaos.txt"
SHA = "countries/exshanstates.txt"
TAM = "countries/extamileelam.txt"
WPA = "countries/exwestpapua.txt"
FLA = "countries/flandersbelgium.txt"
DZG = "countries/freecityofdanzig.txt"
GRN = "countries/Grenada.txt"
HLS = "countries/Holysee.txt"
IPR = "countries/imperialiran.txt"
ASM = "countries/inassam.txt"
ASY = "countries/inassyriarepublic.txt"
BWR = "countries/inbalawaristan.txt"
BLC = "countries/inbalochistan.txt"
JOB = "countries/injewishoblast.txt"
KLB = "countries/inkalimentanborneo.txt"
KMT = "countries/inkamtapur.txt"
KSM = "countries/inkashmir.txt"
KKS = "countries/inkhakasia.txt"
KLS = "countries/inkhalistan.txt"
ACE = "countries/inrepublicofaceh.txt"
OKI = "countries/inrepublicofryukuokinawa.txt"
TAI = "countries/inrepublicoftaiwan.txt"
HOK = "countries/inrepublicofainuhokkaido.txt"
FER = "countries/inrussianfareastrepublic.txt"
SBH = "countries/insabah.txt"
SRW = "countries/insarawak.txt"
SBR = "countries/insiberianrepublic.txt"
SDD = "countries/insindhudesh.txt"
MLK = "countries/insouthmaluku.txt"
TRM = "countries/inturkmeneli.txt"
KRB = "countries/kiribati.txt"
KKD = "countries/komacivakenkurdistan.txt"
KOS = "countries/kosovo.txt"
LES = "countries/lesotho.txt"
LCT = "countries/liechtenstein.txt"
LOM = "countries/lombardy.txt"
MTA = "countries/malta.txt"
MSI = "countries/marshallislands.txt"
MAU = "countries/mauritiana.txt"
MUS = "countries/mauritius.txt"
MNC = "countries/monaco.txt"
NAU = "countries/nauru.txt"
NIU = "countries/niue.txt"
NCY = "countries/northcyprus.txt"
NMC = "countries/northmacedonia.txt"
SDR = "countries/sahrawiarabdemrep.txt"
SKN = "countries/saintkittsandnevis.txt"
SLU = "countries/saintlucia.txt"
SVG = "countries/saintvin.txt"
SOA = "countries/samoa.txt"
SNM = "countries/sanmarino.txt"
STP = "countries/saotomeandprincipe.txt"
SAR = "countries/sardinia.txt"
SCL = "countries/sicily.txt"
SOS = "countries/southossetia.txt"
SSD = "countries/southsudan.txt"
SPE = "countries/sublimepersia.txt"
SWA = "countries/Swaziland.txt"
TVR = "countries/thirdvietnamrepublic.txt"
TON = "countries/tonga.txt"
TSN = "countries/transnistria.txt"
TAT = "countries/trinidadandtobago.txt"
TUS = "countries/tuscanny.txt"
TUV = "countries/tuvalu.txt"
TYR = "countries/tyrol.txt"
WAL = "countries/walloniabelgium.txt"
KPA = "countries/comitteefornorthkorea.txt"
TAL = "countries/taliban.txt"
DAG = "countries/dagestan.txt"
DPR = "countries/Soviet Union.txt"
FAI = "countries/denmark.txt"
FMR = "countries/Central African Republic.txt"
HAM = "countries/ISIS.txt"
HEZ = "countries/ISIS.txt"
HOU = "countries/ISIS.txt"
HSM = "countries/ISIS.txt"
HTS = "countries/ISIS.txt"
STC = "countries/ISIS.txt"
AQY = "countries/ISIS.txt"
NGK = "countries/Soviet Union.txt" 
FPR = "countries/Central African Republic.txt"
ADY = "countries/Soviet Union.txt"
ALT = "countries/Soviet Union.txt"
BSM = "countries/Soviet Union.txt"
BUR = "countries/Soviet Union.txt"
CHU = "countries/Soviet Union.txt"
CRM = "countries/Soviet Union.txt"
KAB = "countries/Soviet Union.txt"
KLM = "countries/Soviet Union.txt"
KRC = "countries/Soviet Union.txt"
KOI = "countries/Soviet Union.txt"
MRE = "countries/Soviet Union.txt"
MRD = "countries/Soviet Union.txt"
JEJ = "countries/Korea.txt"